8 4
############
#@→  #######
#### ###P###
#### ### ###
##P/ //  ⇐&#
####/#######
####P#######
############
d
002
00
00