5 10
#########
#####   #
##@##⇑# #
##↓##&  #
#   * *##
###### ##
#########
d