7 6
###############
## P###########
## *###########
#@→ P   / / ⇐&#
###########/###
########G / ###
###############
d
00
-00
01
00