7 14
############
#@######   #
#↓###### #⇑#
#  #  ## #&#
##   * #/###
#### #   ###
####G#######
############
d
00