10 13
############
#    ##    #
#↑## ## ##⇑#
#@#  ##  #&#
### #### ###
###      ###
############
d